
R   900 500

NO ../textures/pics/eagle.xpm
SO ../textures/pics/mossy.xpm
WE ../textures/pics/wood.xpm
EA ../textures/pics/colorstone.xpm
S ../textures/pics/barrel.xpm

F  227,204,135
C 227,210,159

          1111111
1111111111112001111111111111111111111111111
1000000011110001111000000000000000000000001
1000001000000000000011111110000000000W00001
1000111111111111111111111111111111111111111
1000122200000000000000011111    11220001111
1000102000000110000000000111111111110000111
1000120000000001000000000000001111110000111
1000100000000001000000000000000001110000111
1000121021100001000000000000000000000000111
100012221111000100000000000000000000000111
1000111111111000111110000111111111110000111
1000111111111111111111111111111111110000111
1000000000000000000011100000000000000000111
1000000000000000000000000000000000000000111
11111122011111111111111111111111111111111111
1111111111