R 1000 640
NO ../textures/pics/wood.xpm
SO ../textures/pics/colorstone.xpm
WE ../textures/pics/mossy.xpm
EA ../textures/pics/eagle.xpm
S ../textures/pics/barrel.xpm
F 220,100,0
C 225,30,0


                                    11111111
1111111111111111111111111111111111111111111111111111111 10000001
10000000001100000000000000000000000011        10000001
1011000001110000000000000000000000000111111111100000011111111111111
100100000000000012121212120000000000000000000000000000001
111111111011000021212121210000000000000000000100100010001
10000000001100001212121212000000000000000000100000000001
1111000000010000000000000000000000000000000000011111111111110000111111111111
11110111000100000000S000000000000000000000000000011
11000000110111111111111111111111111111111111111111111111111
10000000000000001100000010001
10000000000000001101010010001
1100000111010101111101111000111
11110111 1110101 101111010001
11111111 1111111 111111111111
