
R   1000 600

NO ../textures/pics/eagle.xpm
SO ../textures/pics/mossy.xpm
WE ../textures/pics/wood.xpm
EA ../textures/pics/colorstone.xpm
S ../textures/pics/barrel.xpm

F  227,204,135
C 227,210,159

    1111111111111111111111111
        1000000000000000000011
    11111000000000000000100011
   100001000S0000000000020000111
1111110010000000000000001111111
10000000100000000000000001
111111111111111111111111111
