
R     1000 600



NO ../textures/pics/wood.xpm
SO ../textures/pics/colorstone.xpm
WE ../textures/pics/mossy.xpm
EA ../textures/pics/eagle.xpm
S ../textures/pics/barrel.xpm

F  227,204,135
C 227,210,159


1111111111111111111
1 1111   1    1 1 1
1     1   1      01
1  111    1   1 1 1
1 1     0 1       1
1  1111 0 1   1 1 1
1    0 N00        1
1 1 1 1 10101 1 1 1
1 00    0     0 0 1
1111    20    11111
1  1    0 0       1
1 11   00000011 111
1 1    101   1    1
1     1111 1 1    1
1111111111111111111

111111111111111111111111111
100000000000000000000000001
100000000000000000000000001
100000000000000000000000001
100000000000000000000000001
100000000000000000000000001
100000000000000000000000001
100000000000000000000000001
100000000000000000000000001111
111111111111111111111111111