
R   1000 600

NO ../textures/pics/eagle.xpm
SO ../textures/pics/mossy.xpm
WE ../textures/pics/wood.xpm
EA ../textures/pics/colorstone.xpm
S ../textures/pics/barrel.xpm

F  227,204,135
C 227,210,159

    111111111111111111111111
        100000000000000000011
    111110020000000000000001
   1000010000002000W0000111
11111100100000000000111111
100000001000000000001
111111111111111111111
