R  1920 1080

NO ./textures/pics/eagle.xpm
SO ./textures/pics/mossy.xpm
WE ./textures/pics/wood.xpm
EA ./textures/pics/colorstone.xpm
S ./textures/pics/barrel.xpm

F  227,204,135
C 227,210,159

          1111111             11111
1111111111112001111111111111111200111111111
1000000011110001111000000000000000000000001
1000001000000000000011111110000000000000001
1000111111111111111111111111111111111111111
1000122200000001000000011111    1122000111
100010200000110000000000011111111111000011
100012000000010000000000000000111111000011
100010000000000100000000000000000111000011
100012102110000100000000000000000000000011
100012221111222210000000000000000000000011
100011111111122211111000011111111111000011
100011111111111111111111111111111111000011
100000100010000000001110000000000000000011
1E00000000000000000000000000000000000000111
111111002111111111111111111111111111111111
1111111111