R 1980 1020
NO ../textures/brick.xpm
SO ../textures/metal.xpm
WE ../textures/wood.xpm
EA ../textures/stone.xpm

S ../textures/stone.xpm
F 220,100,0
C 225,30,0


        1111111111111111111111111
        1000000000110000000000001
        101100000111000000200000111
        10010000000000000E000000001
11111111101100000111000000000000111
110000000011000001110111111111111
11110111111111011100000010001
11110111111111010001010010001
11000000110101010000000000001
10002000000000001100000000001
10000000000000001101010010001
11000001110101011111011110001
11110111 1110101 101111010001
11111111 1111111 111111111111