
R   900 500

NO ../textures/pics/eagle.xpm
SO ../textures/pics/mossy.xpm
WE ../textures/pics/wood.xpm
EA ../textures/pics/colorstone.xpm
S ../textures/pics/barrel.xpm

F  227,204,135
C 227,210,159

111111111111111111111111111
100000001000000000000000001
100000001000000000000000001
100000001000000000000000001
100000001000000000000000001
100000001000000000000000001
100000001000000000000000001
100000001000000010000000001
100000001000000000000000001
1000000010000000E0000020001
100000001000000000000010001
100000001000000000000000001
100000001000000000000000001
100000001000000000000000011111
        1000000000000000000011
   111111000000000000000100011
   10000100000000000000000000111
1111110010000000000000001111111
100000001000000000000000001
100000001000000000000000001
100000001000000000000000001
100000001000000000000000001
100000001000000000000000001
100000001000000000000000001
100000001000000000000000001
100000001000000000000000001
100000001000000000000000001
100000001000000000000000001
100000001000000000000000001
111111111111111111111111111