
R   1000 600

NO ../textures/pics/eagle.xpm
SO ../textures/pics/mossy.xpm
WE ../textures/pics/wood.xpm
EA ../textures/pics/colorstone.xpm
S ../textures/pics/barrel.xpm

F  227,204,135
C 227,210,159

    1111111111111111111111111
        1000000000200000000011
    111110000000200000000001
   10000100100000000001000111
1111110010000000000000000111111
1000000010000000N000000001
111111111111111111111111111
