
R    1000 500
NO ../textures/pics/wood.xpm
SO ../textures/pics/colorstone.xpm
WE ../textures/pics/mossy.xpm
EA ../textures/pics/eagle.xpm
S ../textures/pics/barrel.xpm

F  227,204,135
C 227,210,159


111111111111111111111111111111111111111111111111111111
100000000011000000000000000000010000000000000010000001
1011000001110000000000000000000000000000000000000000011111111111111
10010000000000000000000000000000000000000000000000000100001
11111111101100000000000000000000000000010000000001000100001
10000000001100000E00002000000010000000000000000000000100001
111100000001000000000000000000000000000100000000100011111111111110000111111111111
111101110001000000000000000000010000000000000010000011
1100000011011111111111111111111111111111111111111111111111
10000000000000001100000010001
10000000000000001101010010001
1100000111010101111101111000111
11110111 1110101 101111010001
11111111 1111111 111111111111
