
R   1000 600

NO ../textures/32/brick.xpm
SO ../textures/32/metal.xpm
WE ../textures/32/stone.xpm
EA ../textures/32/wood.xpm
S ../textures/32/pillar.xpm

F  227,204,135
C 227,210,159

1111111111111111111
1 1111   1    1 1 1
1     1   1      01
1  111    1   1 1 1
1 1    0 1       1
1  1111 0 1   1 1 1
1 2     0       2 1
1 1 1 1 N 1 1 1 1 1
1 00    0     0 0 1
1111    00    11111
1  1    200       1
1 11   00000011 111
1 1    101   1    1
1     1111 1 1    1
1111111111111111111

