R 1000 600
NO ../textures/pics/wood.xpm
SO ../textures/pics/colorstone.xpm
WE ../textures/pics/mossy.xpm
EA ../textures/pics/eagle.xpm
S ../textures/pics/barrel.xpm
F 220,100,0
C 225,30,0


                                    11111111
1111111111111111111111111           10000001
1000000000110000000000001           10000001
101100000111000000000000111111111111100000011111111111111
100100000000000000000000000000000000000002000000001000001
1111111110110000000000000000000000000E0000002000100010001
100000000011000000000000000000000000000000001100000000001
1111011111111100000000000000111111111111100001111111111111
11110111111111011101010010001           100001
11000000110101011100000010001           111111
10000000000000001100000010001
10000000000000001101010010001
1100000111010101111101111000111
11110111 1110101 101111010001
11111111 1111111 111111111111
