R 640 480
NO ../textures/pics/wood.xpm
SO ../textures/pics/colorstone.xpm
WE ../textures/pics/mossy.xpm
EA ../textures/pics/eagle.xpm
S ../textures/pics/pillar.xpm
F 220,100,0
C 225,30,0



1111111111111111111111111
1000000000110000000000001
101102000111000000000000111111111111111111111111111111111
100100000000000000000000000000000000000000000000000100001
111111111011000000000000000000000000000000000000000100001
100000000011000000000000000000000000000E00002010000000001
111101111111110000000000000011111111111111111111111111111
11110111111111011101010010001
11000000110101011100000010001
10000000000000001100000010001
10000000000000001101010010001
1100000111010101111101111000111
11110111 1110101 101111010001
11111111 1111111 111111111111
