
R     1000 600



NO ../textures/pics/wood.xpm
SO ../textures/pics/colorstone.xpm
WE ../textures/pics/mossy.xpm
EA ../textures/pics/eagle.xpm
S ../textures/pics/barrel.xpm

F  227,204,135
C 227,210,159


111111111111111111111111111
100000000000000000000000001
100000000000000000000000001
100000000000210000000000001
100000000000000000000000001
100000000000S00000000000001
100000000000000000000000001
100000000000000000000000001
100000000000000000000000001
111111111111111111111111111
