R 1920 1080
NO ../textures/stone.xpm
SO ../textures/brick.xpm
WE ../textures/wood.xpm
EA ../textures/metal.xpm

S ../textures/stone.xpm
F 220,100,0
C 225,30,0


        1111111111111111111111111
        1000000000110000000000001
        101100000111000N00200000111
        100100000000000000000000001
11111111101100000000000000000000111
110000000011000001110001000111111
111100111111110110000000100011
11110011111111010000010010001
11000000110101011000000000001
10002000000000001100000000001
10000000000000001101010010001
11000001110101011111011110001
11110111 1110101 101111010001
11111111 1111111 111111111111