R 1920 1080
NO ../textures/64/bookshelf.xpm
SO ../textures/64/bookshelf.xpm
WE ../textures/64/bookshelf.xpm
EA ../textures/64/bookshelf.xpm
S ../textures/64/crackover.xpm
F 220,100,0
C 225,30,0


        1111111111111111111111111111111
        100000000000000000000000001
        100000000000000000000000001
        10000000011111100000000000111111
        1000000001    100000000000000001
        1000000001    100000002000000001
        10000000011111100000000000000011
        10000000000000000000000000111111
        100000000000000000000000001
        111111111111111111111111111




        11111111111111111111111111
        10000000000000000000000001
        10000000000000000000000001
        10000000000001000000000001
        10000000001010001000000001
        1000E000001000010000000001
        1000000000000011000000001
        10000000001000100000000001
        10000000001000000000000001
        11111111111111111111111111

110000000011000001110001000111111
111100111111110110000000100011
11110011111111010000010010001
11000000110101011000000000001
10002000000000001100000000001
10000000000000001101010010001
11000001110101011111011110001
11110111 1110101 101111010001
11111111 1111111 111111111111