
R   900 500

NO ../textures/pics/eagle.xpm
SO ../textures/pics/mossy.xpm
WE ../textures/pics/wood.xpm
EA ../textures/pics/colorstone.xpm
S ../textures/pics/barrel.xpm

F  227,204,135
C 227,210,159

111111111111111111111111111
100000001000000000000000001
100000001000000000000000001
100000001000000000000000001
100000001000000000000000001
100000001000000000000000001
100000001000000000000000001
100000001000000010000000001
100000001000000000000000001
100000001000000000000000001
100000001000000000000010001
10000000100000000E000020001
100000001000000000000000001
100000001111111100000000011111
111111111      100000000000001
   111111111111100000000100011
   1000010000000000000000000111
1111110010000000000000001111111
100000001000000000000000001
100000001000000000000000001
100000001000000000000000001
100000001000000000000000001
100000001000000000000000001
100000001000000000000000001
100000001000000000000000001
100000001000000000000000001
100000001000000000000000001
100000001000000000000000001
100000001000000000000000001
100000001000000000000000001
100000001000000000000000001
100000001000000000000000001
100000001000000000000000001
100000001000000000000000001
100000001000000000000000001
100000001000000000000000001
100000001000000000000000001
100000001000000000000000001
100000001000000000000000001
100000001000000000000000001
100000001000000000000000001
100000001000000000000000001
100000001000000000000000001
100000001000000000000000001
100000001000000000000000001
100000001000000000000000001
100000001000000000000000001
100000001000000000000000001
100000001000000000000000001
100000001000000000000000001
100000001000000000000000001
100000001000000000000000001
100000001000000000000000001
100000001000000000000000001
100000001000000000000000001
100000001000000000000000001
100000001000000000000000001
100000001000000000000000001
100000001000000000000000001
100000001000000000000000001
100000001000000000000000001
100000001000000000000000001
100000001000000000000000001
100000001000000000000000001
100000001000000000000000001
100000001000000000000000001
111111111111111111111111111