
R    1000 640

NO ../textures/pics/wood.xpm
SO ../textures/pics/colorstone.xpm
WE ../textures/pics/mossy.xpm
EA ../textures/pics/eagle.xpm
S ../textures/pics/pillar.xpm

F  227,204,135
C 227,210,159

                                    11111111
1111111111111111111111111111111111111111111111111111111 10000001
100000000011000000000000000000010000000000000010000001
1011000001110000000000000000000100000000000000100000011111111111111
10010000000000000000000000000001000000000000001000000000001
11111111101100000000000000000001000000200000001001000100001
10000000001100000000000000000001000E00000000001100000000001
1111000000010000000000000000000100000000000000100011111111111110000111111111111
11110111000100000000S000000000010000000000000010000011
1100000011011111111111111111111111111111111111111111111111
10000000000000001100000010001
10000000000000001101010010001
1100000111010101111101111000111
11110111 1110101 101111010001
11111111 1111111 111111111111
