R 1920  1080
NO ../textures/32/wood.xpm
SO ../textures/32/metal.xpm
WE ../textures/32/brick.xpm
EA ../textures/32/stone.xpm
S ../textures/64/crackover.xpm
F 220,100,0
C 225,30,0



1111111111111111111111111
1000000000110000000000001
1011000001110000000000001
100100000000000000000000111111111111111111111111111111111
111111111011000001110000000000000000000000000022200020001
10000000001100000111011111000E000000000000000000020200021
111101111111110111000000100011111111111111111111111111111
11110111111111011101010010001
11000000110101011100000010001
10000000000000001100000010001
10000000000000001101010010001
1100000111010101111101111000111
11110111 1110101 101111010001
11111111 1111111 111111111111
