
R    1000 650



NO ../textures/pics/wood.xpm
SO ../textures/pics/colorstone.xpm
WE ../textures/pics/mossy.xpm
EA ../textures/pics/eagle.xpm
S ../textures/pics/pillar.xpm

F  227,204,135
C 227,210,159


111111111111111111111111111111111111111111111111111111111111111111111
1000000000110000000000000S0001000000000000001000000100000001000000111111111111111111111111111111111111111111111111111111111111111111111111111111111111111111111111111111111111111111111111111111111111111111111111111111111111
101100000111000000000000000000000000000000000000000001111111111111111
10010000000000000000000000000000000000000000000000000000011
1111111110110000000000000000000000000001000000000100010000111111111111111111111111
100000000011000000000000020101000000000000000000000010000010000000000000000000000111111
111100000001000000000000000100040000000011000000001000111111111111111111111111111111
1111011100010000000000000000000100000000000000100000000000110000000000111111111111111
110000001101111111111111111111111111111111111111111111111111111111111111111111111
10000000000000001100000010001
10000000000000001101010010001
11000001110101011111011110001111
11110111 1110101 101111010001
1111111 1111111 1111111111111