R 1920 200
NO ../textures/pics/eagle.xpm
SO ../textures/pics/mossy.xpm
WE ../textures/pics/wood.xpm
EA ../textures/pics/colorstone.xpm
S ../textures/pics/barrel.xpm

C 226,254,184
F 254,254,254

111111111111111111111111
100000000000000011011001
111100000010000000000001111111111
110020W000002000000000001111111111
100000000000001111110002000011111
11000100002000000000001111111211
100010000000000000000111111111111
100200000121100011111101001001112
10000000000000011111100111111111111111111
100000000000000111111011
111111111111111111111111
